XXXXXXXX
X   X  X
X X XX F
X X    X
XEXXXXXX